111111
10P0C1
100001
100001
100001
100001
100001
100001
100001
100E01
100001
111111