1111111
111E111
1110111
101C101
111C111
1110111
1110111
10100C1
1101011
1111011
111P011
1111111
