111111111111111111111111111111111111111111111111111
1E0000000000000C00000C00000000000000000000000000111
101001010010000010100100000001010000000000000000111
101001001010101000100100000001010000000000000000111
1P0000000C00C0000000000000000000C000000000000000111
110000100000010000101111000000001000001011100000011
110000100000010000101111000000001000001011100000111
110000100000010000101111000000001000001011100000011
110000100000010000101111000000001000001011100000011
110000100000010000101111000000001000001011100000011
110000100000010000101111000000001000001011100000011
110000100000010000101111000000001000001011100000011
110000100000010000101111000000001000001011100000011
110000100000010000101111000000001000001011100000011
110000100000010000101111000000001000001011100000011
110000100000010000101111000000001000001011100000111
110000100000010000101111000000001000001011100000011
110000100000010000101111000000001000001011100000111
110000100000010000101111000000001000001011100000011
110000100000010000101111000000001000001011100000011
110000100000010000101111000000001000001011100000111
110000100000010000101111000000001000001011100000011
110000100000010000101111000000001000001011100000111
110000100000010000101111000000001000001011100000011
110000100000010000101111000000001000001011100000011
111111111111111111111111111111111111111111111111111
