111111111111111111
1C0X000CX000X0C001
1E000100C000C00011
1PC0110000X000C001
111111111111111111