111111111111111111
1CXE0001000000C001
10000101X000C0X011
1PC00X0000X0001101
111111111111111111