111111111111111111
1CXE000C0X0000C001
1000X100C000C00011
1PC0110000000XC001
111111111111111111